################
#..............#
#...###........#
#...TTT........#
#...###........#
#...TTT........#
#...###........#
#...TTT........#
#..............#
#..............#
x..............x
x...TT....TT...x
x...TTTTTTTT...x
####TT....TT...#
#..............#
######xx########