#############xx#
#e.............x
#.........#....x
#  .......#....x
#.......###....#
#.......#......#
#.....###......#
#.....#........#
#...###........#
#...#..........#
#...#..........#
#...#########..#
#..............#
##############.#
#@.............#
##############x#