################
x..............#
x..............#
x..............#
#...###T.......#
#...T..........#
#....T.........#
x.....T........#
#......T.......#
#.......T......#
#........T.....x
#.........T....x
#........T.....x
#.......T......#
#......T....e..#
################