################
#...........#..#
#...........#..Q
#...#####...#..Q
#...#...#...#..Q
#...#...#...#..#
#...#...#...#..#
x...#...#...#..#
#...#...#...#..#
#...#...#...#..#
x...#...#...#..#
x...#..........#
x...TT####TT...#
#...TT....TT...#
#..............#
#####QQQ########